#########################################################
######              #########                   #########
############           ###### ################# #########
##########                      ############### #########
#####            ##############         ###       #######
#####  #####                ########### ###  ############
#####     ###########        ##########     #############
#####  ########                ##########################
#####                                          ##########
######      ############### #######          ############
######### ######## ######## ########        #############
######### ######## ######## ######## ###  ###############
#########           ####### ############  ###############
######### #### #### ####### #########     ###############
####      #### #### ####### #######  ####################
#########           ####### ######   ####################
#########      ####  ###### ######         ##############
#########  ##########  #### #########   #################
#########  ########### #### #########   #################
#          ########### #### #########   #################
# #######   ########## #### #########   #################
# ##                              #       ###############
#    #######   ###########   ##########    ##############
#############  ############   #############  ############
#######        #############       ########    ##########
######  #####  ###############                 ##########
######  ####   ############### ##### #######   ##########
####### ####  #################  ### #######    #########
####### ####  ##################                #########
####### ####  ###################### #########  #########
####### ####  ###################### ########## #########
####### ####  ###################### ########## #########
####### ####  ###################### ########## #########
####                                      ###### ########
######### #### ##### #### ##################### #########
########       ##### #### #########                    ##
############## #     #### ############## ########     ###
##############   ########                 ###########   #
#########################################################
