#######################
#                     #
#                     #
#      #              #
#      #####          #
#                     #
#                     #
#                     #
#                     #
#######################