#########################################################
######              #########                   #########
############           ###### ################# #########
##########                      ############### #########
#####                                   ###         #####
#####  #####                ########### ###  ###### #####
#####     ###########        ##########     ####### #####
#####  ########                #################### #####
#####                                          #### #####
######      ############### #######          ###### #####
######### ######## ######## ########        ####### #####
######### ######## ######## ######## ###  ######### #####
#########           ####### ############                #                      ########################
######### #### #### ####### #########     ######### ############################################ ############
####      #### #### ####### #######  #############  ###################### ####################  ############
#########           ####### ######   ############  ######################                            ########
#########      ####  ###### ######                               ######### ######### ####### #######  #########
#########  ##########  #### #########   ##################                 ######### ####### ########  ##########################################################
#########  ########### #### #########   ##################                           ####### ########                ############################################
#          ########### #### #########   ################## ############### ######### ####### ########### ###### ####                                     ########
# #######   ########## #### #########   ################## ############### ######### ####### ########### ###### #### ###############  ############ ##############
# ##                              #       ################                                                            ##############  ############ ##############
#    #######   ###### ####   ##########    ############### ######                         ######################## #################  ############ ##############
#############  ###### #####   #############  ############# ####################                                                             ###### ##############
#######               ######       ########    ########### ###################  ######################## ############### #########################          #####
######  #####  ###############                 ########### ##################  ####################                    # ########################################
######  ####   ############### ##### #######   ########### #################  ########################## ########################################################
####### ####  #################  ### #######    ########## #############               ################# #######
####### ####  ##################                        #                ###########   ######## ######## ######
####### ####  ###################### #########  ########## ##########    ############# ######## ######  ######
####### ####  ###################### ########## #####################   ############## ######## ####   #######
####### ####  ###################### ########## #####################                                ########
####### ####  ###################### ########## #####################  ######################## #############
####                                                                   ##########               #############
######### #### ##### #### ##################### ###################              ############## #############
########       ##### #### #########                    ######################################   #############
############## #     #### ############## ########     #######################################################
##############   ########                 ###########   #####################################################
##################################################################################
